 - 索芙特汉方养护清爽去屑洗发露: 海飞丝丝质柔滑去屑洗发露, 潘婷乳液修复洗发露, 索芙特汉方养护清爽去屑洗发露, 索芙特汉方玫瑰香薰香浴露, 逸婷舒爽顺滑去屑洗发露, 飘柔人参滋养洗发露 
 - 陆员外全塑鸭嘴热水瓶: 半片鸭, 美的极速王豪华电热水壶, 陆员外全塑鸭嘴热水瓶 
 - 巨能家常清凉爽滑面克: 巨能家常拉面克, 巨能家常清凉爽滑面克, 巨能纤味馆爽滑鸡蛋面克, 巨能葱香排骨挂面, 巨能香菇鸡味挂面 
 - 阿里山香瓜子奶香味: 三全麦香早点奶香馒头, 达利园法式软面包香奶味, 阿里山生炒王原味香瓜子, 阿里山香瓜子奶香味 
 - 喜之郎什锦果肉果冻克: 喜之郎什锦果肉果冻克, 喜之郎葡萄苹果果肉果冻克, 喜之郎蜜桔果肉优酪果冻克, 喜之郎黄桃＆蜜桃果肉果冻克, 喜多多什锦椰果克, 散装喜之郎果汁果冻条系列 
 - 妙洁纸杯只装: 天利地垫片装, 妙洁型经济装保鲜膜, 妙洁塑料酷杯只, 妙洁畅饮杯只装, 妙洁纸杯只装, 汰渍全效炫白°洁雅百合无磷洗, 洁成垃圾袋只卷, 雀巢咖啡盒装, （）妙洁神奇抹布 
 - 新疆核桃（一级）: 力士美肤沐浴乳（闪亮冰爽）, 宜慧核桃酥克, 新疆核桃（一级）, 新疆红枣（一级）, 新西兰猕猴桃（一级）, 新鲜生姜（一级）, 统一奶茶（可可） 
 - 红富士（一级）: 杏包菇（一级）, 洋葱头（一级）, 火龙果（一级）, 爱富搪瓷锅盖, 红富士三级, 红富士果（一级）, 红富士（一级）, 红提（一级）, 红瓦房精品浴帘, 红皮花生米（一级）, 红萝卜（一级）, 翠冠梨（一级）, 肉龙眼（一级） 
 - 乐惠排骨紫菜汤克: 乐惠幼嫩紫菜, 乐惠排骨紫菜汤克, 惠惠形象玩偶, 散装新乐福排骨梳打发酵饼干, 百野轩排骨味有机紫菜汤 
 - 六神花露水: 六神喷雾花露水, 六神花露水, 六神花露水大号, 宝中宝蛇胆清凉花露水, 维纳斯多效金银花花露水, 花蛤 
 - 绿箭粒装口香糖克: 益达至尊爽洁微粒无糖口香糖克, 箭牌绿箭分享包薄荷口香糖克, 绿盛百卤坊五香凤爪, 绿箭口香糖片克, 绿箭粒装口香糖克, 绿箭绿茶薄荷口香糖克, 荷氏冰球无糖冰泉蓝莓薄荷糖克, 鸿兴源好德十香粉克 
 - 强生婴儿洗发沐浴露: 六神冰凉超爽沐浴露, 力士白皙焕采靓肤沐浴乳, 唯尔福婴儿尿片小号片, 奥丽颜郁金香水感丝滑沐浴露, 妮维雅防晒隔离润肤露, 强生婴儿洗发沐浴露, 舒肤佳金银花菊花沐浴露, 花慕兰健康美肌沐浴露木瓜美白, 飘柔滋润去屑润发精华素毫升 
 - 海带丝: 带鱼, 干海带, 海带丝, 海带结, 海蜇丝, 福海堂山楂散, 裙带菜 
 - 明治欣欣杯朱古力味克: 明治欣欣杯朱古力味克, 明治欣欣杯朱古力香蕉克, 明治欣欣杯草莓味克, 明治欣欣杯草莓酸奶味饼干条克 
 - 兰中花女中裤: 兰中花女中裤, 卡里卡女中裤, 布兰迪支装圆珠笔, 永亮提绣花割绒毛巾, 钰杰依典女短裤 
 - 喜之郎果冻爽苹果味克: 丰之味梅菜笋丝清香味克, 喜之郎优乐美麦香味奶茶克, 喜之郎果冻爽柠檬味克, 喜之郎果冻爽苹果味克, 喜之郎果冻爽荔枝味克, 喜之郎果冻爽菠萝味克, 喜拖拖吹气男拖 
 - 湾仔码头荠菜猪肉水饺: 五丰高汤芹菜猪肉水饺, 湾仔码头北国香白菜木耳猪肉水饺, 湾仔码头北国香酱香肉三鲜水饺, 湾仔码头荠菜猪肉水饺, 湾仔码头香菇素菜大包 
 - 老州山生虾皮: 对虾, 广中皇老牌腐乳皇白腐乳, 老州山海蜒, 老州山生虾皮 
 - 蓝月亮卫诺衣物消毒液: 爱特福‘’消毒液, 神仙居衣帽架, 蓝月亮卫诺衣物消毒液, 蓝月亮厕宝, 蓝月亮芦荟洗手液芦荟补充装, 蓝月亮衣领净衣领净补充液 
 - 养元六个核桃核桃乳香纯型: 养元六个核桃核桃乳精品型, 养元六个核桃核桃乳香纯型, 养元木糖醇六个核桃核桃乳 
 - 衢州熊猫卫生纸袋装克: 明润皱纹卫生纸克, 白家酸辣粉丝袋装克, 纸音长卷卫生纸卷装, 衢州熊猫卫生纸袋装克 
 - 雕牌生姜洗洁精千克: 奥妙超效洗衣皂含芦荟精华克, 立白生姜洗洁精千克, 雕牌生姜洗洁精千克, 雕牌超效洗洁精千克　, 雕牌透明皂阳光清柠克, 高露洁健康健洁薄荷牙膏克 
 - 蒙牛真果粒牛奶饮品桃果粒: 惠尔康谷粒谷力红豆浆饮品毫升, 蒙牛早餐奶（核桃）, 蒙牛真果粒牛奶饮品桃果粒, 蒙牛真果粒牛奶饮品草莓果粒 
 - 霍尔格断码女凉鞋: 绿都公子夹脚男凉拖鞋, 踏佳路镂空女凉鞋, 雅耐尔牛皮中跟女凉拖鞋, 霍尔格断码女凉鞋 
 - 超能椰果洗衣皂: 立白强效去渍洗衣皂克, 超能去渍洗衣粉（倍净焕彩）, 超能柠檬草洗衣皂, 超能椰果植物焕彩洗衣皂, 超能椰果洗衣皂, 超能香樟洗衣皂 
 - 青蛙爽朗型牙刷: 三笑摩力护龈牙刷, 丹芭碧持久定型渚喱, 佳洁士茶爽炫白（柠檬茶香型）牙膏, 青蛙爽朗型牙刷, 青蛙特爽柔丝牙刷 
 - 伊利纯牛奶: 伊利冰工厂冰片蜜桃棒冰, 伊利巧乐兹经典巧脆棒雪糕, 伊利纯牛奶, 伊利谷粒多牛奶饮品红, 伊利高钙奶, 光明纯鲜牛奶, 利群老版, 爱得利初生宝宝专用奶嘴, 爱得利高耐热玻璃奶瓶, 蒙牛纯牛奶 
 - 海天海鲜酱克: 上海药皂高级透明药皂, 亨氏番茄酱, 厨邦美味鲜酱油, 可佳荣达海苔凤凰卷克, 天作洋槐蜜, 海天招牌拌饭酱香辣克, 海天海鲜酱克, 海天特级味极鲜酱油, 海天红烧王酱油, 海天草菇老抽酱油, 海天锦上鲜蒜蓉辣椒酱克, 海天黄豆酱 
 - 安琪马来西亚风味杏仁酥克: 仙客来金针菇克, 安琪马来西亚风味杏仁酥克, 安琪马来西亚风味松籽酥克, 安琪马来西亚风味腰果酥克, 安琪马来西亚风味花生酥克 
 - 五丰玉米刀切: 五丰刀切馒头, 五丰好媳妇灌汤水饺芹菜猪肉, 五丰玉米刀切, 五丰黑米刀切, 翰丰丝苗米籼米, 西王玉米胚芽油, 黑糯玉米只 
 - 莲子一级: 乐美汇食品级茶杯, 嘎啦一级, 散花菜一级, 白木耳一级, 花生米一级, 芽变葡萄一级, 莲子一级 
 - 一级哈密瓜: 一品珍白木耳, 一级哈密瓜, 一级国产黑布林, 一级水蜜桃, 一级藤稔葡萄, 一级青提, 二级哈密瓜 
 - 喜之郎美好时光原味海苔克: 喜之郎美好时光原味海苔克, 喜之郎美好时光海苔克 
 - 北方绿人加钙酥性饼干克: 包大人成人加长型纸尿片片, 北方绿人加钙酥性饼干克, 北方绿人绿色杂粮木糖醇消化饼干, 南方女人多维豆浆粉, 思朗纤麸无添糖消化饼干克 
 - 世家清洁球（只装）: 世家中号点断式保鲜袋（只只, 世家刷洗球只装, 世家清洁球（只装）, 爱家固体清香剂超值装沁凉香柠, 雕牌天然皂粉（家庭装） 
 - 男领短袖针织衫: 卡度男圆领短袖针织衫, 男领短袖针织衫 
 - 莲虹男短裤: 女中童牛仔短裤, 琪悦男童帽, 莲虹少女背心, 莲虹弹力棉女短裤, 莲虹男士平脚短裤, 莲虹男短裤, 金郎格男休闲中裤, 零接触男夏季清仓短裤, 麦奇哈男运动短裤 
 - 大好大奶油瓜子袋装克: 大好大奶油瓜子袋装克, 大好大奶油香瓜子纸袋克, 大好大水煮花生香辣牛肉味克, 大好大纸包瓜子克, 大热带酒酿克, 威猛厨房重油污净双包装克, 恒康甘草瓜子克 
 - 单晶冰糖散: 单晶冰糖散, 多晶冰糖散, 红糖散 
 - 康师傅冰红茶: 娃哈哈冰红茶, 康师傅冰红茶, 康师傅冰红茶柠檬口味茶饮品, 康师傅冰红茶柠檬味利乐包, 康师傅冰绿茶瓶装, 康师傅妙芙法式蛋糕牛奶红豆味, 康师傅橙汁饮品, 康师傅矿物质水 
 - 河鲫鱼（三级）: 河鲫鱼, 河鲫鱼（三级）, 舜吉鲜汁三黄鸡, 藕（三级）, 鲈鱼（三级）, 黑茄（三级） 
 - 蒙牛酸酸乳草莓味乳饮料: 伊利星儿童草莓味乳饮品, 统一奶茶（草莓）味饮料, 蒙牛妙妙草莓乳酸饮品, 蒙牛果蔬酸酸乳草莓味饮品, 蒙牛酸酸乳草莓味乳饮料, 蒙牛酸酸乳蓝莓味乳饮料, 雪莲天然乳胶家用手套中号 
 - 今麦郎手打拉面克: 今麦郎手打拉面克, 今麦郎手打鸡蛋面克, 今麦郎葱香排骨面克五连包, 味千猪骨汤拉面, 安安青瓜增白洗面奶克, 宫川荞麦挂面克, 弘生新华手提小号拉圾桶, 运隆带手柄水桶大, 麦轩老婆饼克 
 - 唯新儿童营养肉酥克: 亨氏优加营养胡萝卜面条克, 倍思特儿童肉松克, 唯新儿童营养肉酥克, 唯新无糖营养肉酥克, 唯新特级肉松克, 唯新猪肉酥克, 绿盛儿童营养牛肉松克, 绿盛儿童营养牛肉酥克 
 - 维达抽取式面巾纸抽: 三江购物梦幻心情抽取式面巾纸双, 南阳之星双层抽取式面巾纸抽, 心相印茶语抽取式面巾纸抽, 洁云提取式面巾纸抽, 维达抽取式面巾纸抽, 维达抽取式面巾纸抽包, 维达蓝色经典卷筒纸卷装, 雪松面巾纸张, 雷宇羊角锤磅 
 - 娃哈哈营养快线牛奶果昔饮品原味: 娃哈哈营养快线果汁牛奶饮品原味, 娃哈哈营养快线果汁酸奶饮品椰子味, 娃哈哈营养快线牛奶果昔饮品原味, 娃哈哈营养快线牛奶果昔饮品菠萝味 
 - 润亨阿胶蜜枣克: 亲友阿胶枣, 冠生园蜂蜜克, 友益佳阿胶枣, 智神无核阿胶蜜枣克, 润亨红珍珠迷你山楂片克, 润亨阿胶蜜枣克 
 - 美汁源果粒橙橙汁饮料: 美汁源果粒奶优饮料清新草莓味, 美汁源果粒奶优饮料清香菠萝味, 美汁源果粒橙橙汁饮料, 美汁源热带果粒果粒橙组合, 美汁源爽粒红葡萄水果饮料, 美汁源爽粒葡萄葡萄汁饮料, 雪碧美汁源果粒橙两联 
 - 众望小麻花海苔咸味克: 众望小麻花低糖芝麻甜味克, 众望小麻花海苔咸味克, 口水娃香脆兰花豆五香味克, 宏继小酥饼咸味克 
 - 雕牌洗洁精: 元宝牌优质特精小麦粉, 慧吉洗洁精, 维纳斯牛头牌高效去油洗洁精, 雕牌洗洁精, 雕牌洗洁精克 
 - 上好佳辣味虾条: 上好佳芝士条, 上好佳辣味虾条, 金丝猴馋嘴猴上汤鸡汁味豆干 
 - 红牡丹面碗: 依尔布面小折凳, 希尔波边碗, 广博卡面办公软抄大型, 红牡丹斗碗, 红牡丹深盘, 红牡丹针匙, 红牡丹面碗, 红鸟液体鞋油黑色 
 - 蓝怡雪无托文胸: 蓝怡雪印花蕾丝有托文胸, 蓝怡雪文胸（）, 蓝怡雪无托文胸, 蓝怡雪无托竹炭纤维文胸, 蓝怡雪特大有托文胸, 蓝怡雪竹纤维裹胸, 蓝怡雪裹胸 
 - 苏泊尔好帮手精铸铁锅: 应源搪瓷防锈铁锅, 科立泰迷你火锅, 苏泊尔好帮手精铸铁锅, 苏泊尔豪华自动电饭煲 
 - 好丽友好多鱼烧烤味克: 三辉叮当铜锣烧红豆味克, 味聚特烧烤藕片克, 好丽友好友趣多汁牛排味切片型马铃, 好丽友好多鱼烧烤味克, 好丽友好多鱼鲜香海苔味克, 好丽友蘑古力红豆精灵克 
 - 青瓜（一级）: 丝瓜（一级）, 冬瓜（一级）, 南瓜（一级）, 大葱（一级）, 尖椒（一级）, 山竹（一级）, 日本南瓜（一级）, 木瓜（一级）, 梅豆（一级）, 灯椒（一级）, 生姜（一级）, 紫甘薯（一级）, 苦瓜（一级）, 茼蒿（一级）, 荷兰青瓜（一级）, 长瓜（一级）, 青瓜（一级）, 青苹果（一级）, 青菜（一级） 
 - 青岛啤酒纯生度罐装: 百威度啤酒拉罐, 蓝带啤酒度拉罐, 雪花啤酒清爽度罐, 青岛啤酒奥古特度罐装, 青岛啤酒纯生度罐装 
 - 丘比沙拉酱香甜味克: 丘比原味沙拉酱克, 丘比沙拉酱香甜味克, 椰乡春光椰香脆饼克, 母亲佐餐牛肉酱香浓咖喱克 
 - 上好佳番茄口味田园薯片克: 上好佳烤肉味田园薯片克, 上好佳玉米口味田园泡, 上好佳番茄口味田园薯片克, 可比克香辣薯片克, 盼盼番茄味薯片家庭装克 
 - 亲友白砂糖: 亲友枸杞王, 亲友清凉粥, 亲友白砂糖, 亲友红糖, 甘霖白砂糖, 白砂糖散 
 - 鸭爪: 鸡爪, 鸭爪, 鸭边腿 
 - 雯丽芦荟原液深层补水面贴膜片装: 雯丽冰纯高倍补水面膜贴片装, 雯丽红酒多酚炫透亮白面贴膜片装, 雯丽芦荟原液深层补水面贴膜片装, 雯丽豆乳蛋白水润白皙面贴膜片装 
 - 统一老坛酸菜牛肉味面克: 今野拉面雪菜肉丝面包, 统一卤肉拌面卤香牛肉味克, 统一来一桶红烧牛肉面克, 统一精炖番茄牛肉面克, 统一老坛酸菜牛肉味面克, 统一老坛酸菜牛肉面克, 统一老坛酸菜牛肉风味酱拌面克, 统一鲜橙多冰红茶柠檬味搭扣 
 - 动心一族奶油果仁蛋糕克: 动心一族奶油果仁蛋糕克, 动心一族迷尔山楂克, 散装动心一族奶油果仁蛋糕 
 - 娃哈哈花生牛奶蛋白饮品: 娃哈哈桂圆莲子营养八宝粥克, 娃哈哈爽歪歪益生菌酸奶饮品, 娃哈哈花生牛奶蛋白饮品, 娃哈哈钙奶饮料, 银鹭花生牛奶蛋白饮料 
 - 太太乐加鲜味精克: 太太乐加鲜味精克, 太太乐宴会特鲜酱油, 太太乐度晶体味精, 太太乐蔬之鲜调味料, 太太乐醇珍鲜鸡汁, 太太乐鸡精克 
 - 蓝怡雪男内裤: 真想您二条男红满福全棉平脚裤, 紫丁香雪怡八角壶, 络华弹力棉男童平脚裤条, 蓝怡雪女内裤, 蓝怡雪小平脚男裤, 蓝怡雪男内裤 
 - 清美五香油干: 海客瑞斯厨宝四季飘香油壶, 清美五香油干, 清美传统腐竹, 清美四鲜烤麸, 清美素香糕散, 清美高房内酯豆腐, 甬江特制五年加饭酒, 红味斋香蒜汁, 食上川府豆干散装 
 - 美则胜研磨丝细牙刷型支装: 三笑刚柔并济牙刷二支装, 佳洁士超细毛养龈牙刷两支装第支, 可洁可净物理磨尖毛牙刷支装, 皎洁全效细丝软毛牙刷特惠装, 美则胜研磨丝细牙刷型支装, 美则胜软毛牙刷二支 
 - 奥利奥香草巧克力味夹心饼干克: 五丰上口爱巧克力香草甜筒, 原野物语鸡蛋味蛋圆饼干克, 奥利奥香草巧克力味夹心饼干克, 康师傅甜酥鲜果蓝莓夹心饼干克, 森和园雪丽糍巧克力味棉花糖克, 金必氏愉快动物饼紫菜味饼干克 
 - 恒顺镇江香醋: 恒顺山西老陈醋, 恒顺酿造白醋, 恒顺镇江香醋, 金山恒顺御宴醋 
 - 蓝月亮亮白增艳深层洁净洗衣液薰衣: 蓝月亮亮白增艳深层洁净洗衣液自然, 蓝月亮亮白增艳深层洁净洗衣液薰衣, 蓝月亮深层洁净护理洗衣液薰衣草香 
 - 乌江涪陵榨菜克: 乌江三榨微辣榨菜克, 乌江涪陵原味榨菜片, 乌江涪陵榨菜克, 乌江涪陵榨菜鲜爽菜丝克, 乌江牌鲜香菜丝克, 备得福麻油榨菜克, 忆江南黄山贡菊克 
 - 乐事清新清爽小番茄味薯片: 乐事墨西哥鸡汁番茄味薯片, 乐事得克萨斯烧烤味薯片, 乐事意大利香浓红烩味薯片, 乐事无限黑椒牛扒味薯片克, 乐事法国脆香鸡翅味薯片, 乐事清新清爽小番茄味薯片, 乐事清新清爽黄瓜味薯片 
 - 相宜本草男士洁面乳: 小青英杰男士磨砂洁面膏, 相宜本草男士洁面乳, 阿迪达斯男士控油平衡霜 
 - 三珍斋食用淀粉: 三珍斋多油咸鸭蛋, 三珍斋食用淀粉, 塞翁福红薯淀粉, 雪健家庭用小麦粉 
 - 金龙鱼玉米油: 大黄鱼条, 妙脆角玉米角美式茄汁味, 威龙樽杯红葡萄酒, 金标金华腊肉, 金海鸥电动钓鱼, 金钟玫瑰米醋袋装, 金龙鱼橄榄原香食用调和油, 金龙鱼玉米油, 金龙鱼第二代调和油, 长寿花金胚玉米油 
 - 引发雪菜克: 引发美味雪菜克, 引发雪菜克, 旺旺仙贝克, 欣荣行笋丝雪菜克包 
 - 云楼龙眼萝卜头: 云楼大蒜头, 云楼甜酸荞头, 云楼美味大头菜, 云楼肖山萝卜, 云楼龙眼萝卜头, 楼龙博士杯 
 - 太平奶盐梳打饼干克: 卡夫三层高钙梳打饼干香葱蔬菜味, 太平奶盐梳打饼干克, 太平香葱梳打饼干克, 日盈无蔗糖减盐苏打饼干鲜葱味 
 - 拥有孝感米酒: 拥有孝感米酒, 拥有孝感米酒饮料型, 沙宣空气感卷发蜡, 神霖孝感米酒 
 - 护舒宝超值干爽丝薄夜用卫生巾片: 唯尔福干爽丝薄护翼卫生巾, 帮宝适超薄干爽系列中包装初生型, 护舒宝瞬洁贴身量多日用夜用卫生, 护舒宝超值干爽丝薄夜用卫生巾片, 护舒宝超值干爽贴身日用卫生巾片 
 - 可口可乐汽水: 可口可乐汽水, 可口可乐酷儿橙汁组合装, 新康可甜酒酿, 激浪柠檬味可乐型汽水, 零度可口可乐汽水拉罐无糖 
 - 安尔乐纯棉卫生护垫无香片: 丝薄棉柔卫生护垫片, 妈妈乐妇婴两用垫片, 安尔乐清爽卫生护垫无香片（, 安尔乐纯棉卫生护垫无香片, 护舒宝透气纯棉感轻薄卫生护垫淡香, 维达手部卫生湿巾片 
 - 东海男汗布三角裤: 东洋包氏酱卤味鸡腿, 东海儿童汗布印花三角裤, 东海棉毛平角裤, 东海男汗布三角裤, 安妮芳条装女弹力棉三角裤（, 白猫高级百洁布买三片送一片 
 - 五丰鲜肉包: 五丰糯滋滋麻芯小汤团, 五丰豆沙包, 五丰鲜肉包, 五丰麻蓉包, 五芳斋速冻鲜肉粽熟制, 豪丰欧式盆 
 - 凯旋溜溜话梅克: 凯旋溜溜九制梅话化类, 凯旋溜溜话梅克 
 - 益民糯米黄酒: 北高峰糯米黄酒（袋）, 散装糯米, 益民料酒, 益民糯米黄酒 
 - 富华林核桃仁: 华林透明纸巾筒, 富华林原果桂圆肉, 富华林核桃仁, 富华林花生仁, 澳华号橡胶篮球 
 - 老干妈油辣椒克: 三和麻油红方腐乳克, 坛坛香精致剁辣椒克, 婆婆嘴野山椒凤爪克, 松川屋油炸青豆麻辣味克, 老干妈油辣椒克, 老干妈肉丝豆豉油辣椒克, 香哆哆香辣青豆克, 鸿兴源朝天椒克 
 - 格力高菜园小饼比萨味克: 日清格力高菜园小饼蕃茄味克, 格力高菜园小饼比萨味克, 波力鳕柳丝原味克, 萨啦咪小鸡腿薰味克 
 - 蒙牛益生菌酸牛奶原味: 光明益生菌酸牛奶原味, 光明莫斯利安酸牛奶原味盒, 光明莫斯利安酸牛奶钻石原味, 星福益零嘴梅话梅经典原味, 蒙牛内蒙古老酸奶原味, 蒙牛未来星智慧牛奶原味, 蒙牛益生菌酸牛奶原味, 蒙牛酸牛奶原味 
 - 宝牌龙口粉丝: 双塔龙口绿豆粉丝, 塔牌绍兴酒度, 宝牌龙口粉丝 
 - 蒙牛优益活菌型乳酸菌乳饮料芦荟: 养乐多活性乳酸菌乳饮品支, 蒙牛优益活菌型乳酸菌乳饮料原味, 蒙牛优益活菌型乳酸菌乳饮料芦荟 
 - 益达无糖口香糖清爽西瓜味克: 益达无糖口香糖清爽西瓜味克, 益达无糖口香糖热带水果味片克, 益达木糖醇口香糖清爽西瓜味克, 益达木糖醇无糖口香糖香浓蜜瓜味, 荷氏草本润喉糖冰糖雪梨味克, 醒目西瓜汁 
 - 野生鲶鱼: 可扬野生紫菜, 外塘甲鱼, 野生鲶鱼 
 - 云楼榨菜芯: 云楼八宝菜, 云楼姜笋, 云楼学生榨菜丝, 云楼小菜榨菜, 云楼榨菜条, 云楼榨菜笋丝, 云楼榨菜芯, 云楼精什锦, 云楼荷兰瓜, 洁云迷你手帕纸包 
 - 吉列超滑旋转刀架及剃须泡: 吉列威锋旋转双层刀架及刮胡泡超值, 吉列超滑旋转刀架及剃须泡 
 - 清风抽取式面纸抽: 南阳之星时尚系列双层抽取面纸, 双熊猫抽取式绉纹卫生纸张, 妙洁抽取式保鲜袋中号, 广博拍纸薄, 洁柔布艺软抽抽, 清风克三层卷筒纸卷, 清风原木纯品抽取式面纸, 清风抽取式面纸抽, 清风抽取式面纸经济装抽层, 清风超质感抽取式面巾纸抽, 飞科折叠式电吹风 
 - 味之园芦荟汁饮品: 上海芦荟皂, 味之园芦荟汁饮品, 味之园芦荟苹果汁饮品, 味老大炭化无漆竹筷双, 甘汁园姜汁红糖 
 - 冷酸灵清凉薄荷防菌抗敏牙膏: 中美史克舒适达全面护理清新牙膏, 冷酸灵井盐爽白双重抗过敏牙膏, 冷酸灵儿童防蛀牙膏, 冷酸灵清凉薄荷防菌抗敏牙膏, 冷酸灵脱敏牙膏水果香型克, 黑人双重薄荷原味清凉牙膏克, 黑人茶倍健薄荷含氟牙膏 
 - 旺旺碎冰冰果味饮料草莓味: 旺旺碎冰冰果味饮料乳酸味, 旺旺碎冰冰果味饮料柑桔味, 旺旺碎冰冰果味饮料桃子味, 旺旺碎冰冰果味饮料草莓味, 旺旺碎冰冰果味饮料菠萝味, 旺旺碎冰冰综合水果味饮料, 滨崎碗仔糖果蓝莓香橙草莓味, 福马咪咪油炸小食品红烧牛肉味 
 - 佛手味精度克: 佛手味精度, 佛手味精度克, 味家木铲, 如意水磨精制年糕 
 - 蒙牛高钙低脂牛奶: 蒙牛新养道低乳糖牛奶, 蒙牛新养道珍养牛奶, 蒙牛未来星儿童肠胃成长牛奶, 蒙牛特仑苏低脂奶, 蒙牛高钙低脂牛奶, 蒙牛高钙牛奶 
 - 良厨御点手工猪肉芹菜水饺: 三全面点坊香菇素菜包, 良厨御点手工猪肉芹菜水饺, 良厨御点猪肉馄饨, 良厨灌汤鲜肉水饺 
 - 果然多卷玉露蜜桃味克: 果然多卷清新苹果卷克, 果然多卷玉露蜜桃味克, 果然多卷甜蜜瓜克, 脉动维生素饮料水蜜桃口味 
 - 香菜（一级）: 兰州包心菜（一级）, 国产香蕉（一级）, 土豆（一级）, 大白菜（一级）, 小白菜（一级）, 小葱（一级）, 带豆（一级）, 木耳菜（一级）, 李字（檀香型）蚊香双盘, 百合（一级）, 空心菜（一级）, 芋艿（一级）, 芹菜（一级）, 萝卜（一级）, 蒜头（一级）, 西红柿（一级）, 韭菜（一级）, 香菜（一级）, 黄芽菜（一级）, 黑茄（一级） 
 - 乡下妹古制去皮榨菜克: 乡下妹古制去皮榨菜克, 乡下妹学生去皮榨菜丝, 乡下妹榨菜芯克 
 - 绿豆: 小红豆, 绿豆, 赤豆 
 - 民益芝麻桃酥: 尚麦葵仁小酥, 民益芝麻桃酥, 淘大芝麻油 
 - 奇多干杯脆美式火鸡味粟米粒克: 奇多干杯脆日式牛排味粟米粒克, 奇多干杯脆美式火鸡味粟米粒克, 百事奇多美式火鸡味粟米棒克, 金富士脆美司红番茄棒饼克 
 - 三江购物保鲜膜促销装: 三江购物保鲜膜促销装, 三江购物保鲜袋促销装, 三江购物有芯三层平纹卷纸卷装, 三江购物简装保鲜膜, 华净彩色环保分类垃圾袋, 洁成保鲜膜 
 - 佳宝九制陈皮克: 佳宝九制工坊九制酱芒果克, 佳宝九制陈皮克, 加碘精制盐克 
 - 卡夫闲趣清咸自然原味韧性饼干: 卡夫乐之小清新土豆原味土豆脆片, 卡夫闲趣清咸自然原味韧性饼干, 散装卡夫闲趣清咸自然原味韧性饼干, 雪涛日晒自然盐克 
 - 华味亨珍珠梅克: 华味亨冰糖杨梅克, 华味亨珍珠梅克, 香飘飘珍珠奶茶香芋克 
 - 三辉麦风优之晨早餐包克组合装: 三辉麦风优之晨早餐包克组合装, 三辉麦风提拉米苏巧克力味蛋糕, 启航餐具, 贝因美营养米粉组合装 
 - 太子乐乳清蛋白营养米粉: 太子乐中老年奶粉, 太子乐乳清蛋白营养米粉, 太子乐胡萝卜营养米粉, 太子乐铁锌钙奶粉, 贝因美段乳清蛋白营养米粉克 
 - 全无敌杀虫气雾剂清香型: 全无敌杀虫气雾剂清香型, 全无敌电热蚊香片清香型片加, 全无敌蚊香花香型双盘, 枪手杀飞虫气雾剂毫升, 榄菊杀虫气雾剂清香柠檬 
 - 丝诺纯棉木棒棉签支装: 丝诺纯棉木棒棉签支装, 晨光中性笔支装, 银鹭桂圆八宝粥, 长城医用棉签支 
 - 清凉粥料散: 八宝粥料散, 加多宝凉茶亳升, 清凉粥料散 
 - 心相印优选通用清洁湿巾片装: 心相印优选通用清洁湿巾片装, 心相印优选通用清洁湿巾独立装片, 心相印婴儿专用面巾纸抽, 心相印手帕纸包装 
 - 鲜鸡蛋: 光皮蛋, 初生蛋, 宫川儿童全鲜鸡蛋蝴蝶面, 山黄鸡蛋, 本地鲜鸡蛋, 鲜一族卤鸡蛋克, 鲜鸡蛋 
 - 奥妙净蓝全效无磷洗衣粉: 三江购物无磷洗衣粉, 奥妙全自动洁彩无磷洗衣粉千, 奥妙净蓝全效无磷洗衣粉, 奥妙净蓝全效无磷洗衣粉克, 奥妙净蓝全效水清莲香无磷洗衣粉, 奥妙超效洗衣皂 
 - 农夫山泉饮用天然水: 农夫山泉量贩装水, 农夫山泉饮用天然水, 怡宝饮用纯净水, 白大夫瞬透补湿隔离霜, 统一饮用天然矿泉水 
 - 普通浴花: 中号充气卡通玩具, 云蕾七彩浴花, 双艺浴帘, 普通浴花, 洁身妙浴搓泥 
 - 老李五香鸡翅克: 味好美脆皮香辣炸鸡配料克, 小燕子香酥鱼仔克, 扁担老头五香味豆干, 老李五香干克, 老李五香蛋克, 老李五香鸡翅克, 舜吉香脆鸡排克, 萨拉咪琵琶翅克 
 - 康师傅苏打夹心饼干香草巧克力: 卡夫王子曲奇星饼干香浓巧克力味, 康师傅苏打夹心饼干蓝莓味克, 康师傅苏打夹心饼干香草巧克力, 麦香堡夹心豆沙面包克 
 - 榄菊蚊香大盘装（无烟型）: 威猛先生洁厕液双包装（柠檬草香）, 榄菊蚊香大盘装（无烟型）, 榄菊蚊香大盘装（高级型）, 睡的香蚊香大盘无烟檀香单 
 - 雪碧清爽柠檬味汽水: 七喜冰爽柠檬味汽水, 雪碧汽水, 雪碧清爽柠檬味汽水 
 - 珍宝珠混合味硬糖棒棒糖克: 不二家棒棒糖克支, 如果他夹心棒棒糖, 彩虹原果味果汁糖克, 珍宝珠混合味硬糖棒棒糖克, 顶汁味菊花冰糖 
 - 舒肤佳纯白清香型香皂克: 舒肤佳柠檬香皂克, 舒肤佳纯白清香型香皂, 舒肤佳纯白清香型香皂克, 舒肤佳芦荟香皂克 
 - 百事可乐果缤纷混合果汁: 百事可乐, 百事可乐七喜搭扣装, 百事可乐果缤纷混合果汁, 百事可乐纯果乐鲜果粒橙汁饮, 百雀羚蚕丝丝素净白莹润柔肤水 
 - 光明酸奶: 光明牌酸奶, 光明纯牛奶利乐枕, 光明芦荟酸奶, 光明酸奶, 光明酸奶原味经济装, 光明酸牛奶红枣味, 光明酸牛奶饮品利乐枕原味, 富光炫耀太空杯型 
 - 旺仔牛奶复原乳: 旺仔小馒头原味蜂蜜, 旺仔牛奶复原乳, 旺仔牛奶灭菌调味牛乳 
 - 酷儿橙汁饮料: 绿力冬瓜茶饮料, 酷儿橙汁饮料, 酷儿橙汁饮料两联装 
 - 双汇王中王优级火腿肠: 双汇午餐火腿, 双汇王中王优级火腿肠, 双汇王中王优级火腿肠克, 双汇王中王优级火腿肠支装, 双汇王中王骨香风味特级火腿肠, 双汇精制香辣香脆肠, 黄芩中药高级牙膏克 
 - 福临门天然谷物调和油升: 福临门东北优质大米, 福临门天然谷物调和油升, 福临门非转基因压榨葵花籽油升 
 - 咸亨香糟卤: 咸亨南乳汁, 咸亨辣味腐乳克, 咸亨香糟卤, 宝鼎天鱼香糟卤 
 - 小米散: 小米散, 杂粮面散, 楚源香米散, 清美精制小素肠散, 葵花阳光大米散装, 薏米仁散, 长粒香糯米散, 香软粳米散装, 高粱米散, 鸡小腿单冻, 黑米, 黑豆散 
 - 散装东北大米三江购物: 中汇东北大米, 散装东北大米三江购物, 散装东北米中汇, 散装东北长粒香米三江购物, 散装苏微快乐锅巴日式牛排味 
 - 三江购物龙须面: 三江购物东北珍珠米, 三江购物大豆油, 三江购物头椭圆晒架, 三江购物整理箱, 三江购物洗手液, 三江购物白砂糖, 三江购物精制拉面, 三江购物营养蛋面, 三江购物龙须面, 塑料购物袋大 
 - 芬达橙味汽水: 百事可乐美年达橙味汽水搭扣, 芬达橙味汽水, 芬达橙汁汽水 
 - 佳倍波纹面克黄: 佳倍波纹面克黄, 佳倍玉兰面克, 佳雪渗透面膜心动装, 波纹面一级 
 - 佳洁士防蛀修护牙膏清新青柠香型: 佳丽空气清新喷雾桂花飘香, 佳洁士全优效牙膏克配磨砂水杯, 佳洁士盐白牙膏洁白清新克, 佳洁士防蛀修护牙膏清新青柠香型, 佳洁士防蛀修护牙膏清莲薄荷, 娇爽护垫清晨淡香片, 黄芩修护牙膏（黄瓜香型）克, 黑妹茶极爽牙膏龙井薄荷香型, 龙士达小号清新冷水壶 
 - 苏菲动感丝薄日用卫生巾片: 七度空间纯棉夜用超薄卫生巾片, 丝尚亲肤柔棉日夜组合卫生巾片, 妈咪宝贝超薄瞬吸男婴纸尿裤片, 朵朵棉舒超薄日用卫生巾片, 苏菲动感丝薄日用卫生巾片, 苏菲动感丝薄超长吸收片装, 苏菲安心棉柔表层纤巧日用卫生巾, 苏菲弹力贴身极薄日用卫生巾片, 苏菲超薄随心翻超熟睡夜用卫生 
 - 圣茗香原味鹌鹑蛋: 圣茗香原味蛋, 圣茗香原味鹌鹑蛋, 圣茗香鹌鹑蛋克, 星燎原图书, 波力海苔原味克切枚, 牛奶果然多香醇原味特浓奶卷奶糖 
 - 散装徐福记糕饼系列: 散装康元咸味忌司, 散装徐福记糕饼系列, 民益散装打折糕点系列 
 - 闽洋海蛰丝海鲜味: 可扬亚达汤料海鲜味, 闽洋海蛰丝海鲜味, 闽洋海蛰丝香辣味, 阿一波紫菜汤海鲜味克 
 - 鲁花压榨特香菜籽油: 福有菜籽油, 鲁王特精粉, 鲁花压榨一级花生油, 鲁花压榨特香菜籽油, 鸡翅根特等 
 - 康师傅酸菜牛肉面克: 康师傅妙芙蛋糕奶油味克, 康师傅番茄笋干排骨面克包, 康师傅笋干烧肉面克包, 康师傅红烧牛肉面大食袋克包, 康师傅红烧牛肉面桶装克, 康师傅红烧牛肉面随心杯克杯, 康师傅蛋黄也酥酥克, 康师傅酸菜牛肉桶面克, 康师傅酸菜牛肉面克, 康师傅雪菜大汤黄鱼面克包, 康师傅香菇炖鸡袋面克, 康师傅香辣牛肉袋面克, 日清开杯乐五香牛肉面克, 汤师傅紫菜虾米汤克, 盼盼烧烤牛排克, 顶味面の伴侣香辣牛肉酱克 
 - 百顺割绒提花童巾: 洁玉英伦风尚毛巾, 百顺割绒勾边提花童巾, 百顺割绒提花童巾 
